02 02 02 02 02 04 00 02 02 07 00 00 00 00 00 00 00 00 00 00 07
05 05 02 00 00 00 00 00 00 00 02 02 00 02 02 02 00 02 02 00 00
05 05 02 00 00 00 00 00 00 00 00 04 00 00 00 00 00 02 02 00 00
05 05 05 05 02 02 06 06 06 06 06 06 06 06 06 06 06 00 00 06 06
05 05 05 05 02 02 06 06 06 06 06 06 06 06 06 06 06 00 00 06 06
00 00 02 02 00 00 00 00 00 00 07 00 00 00 00 00 00 00 00 00 00
02 02 02 02 00 02 02 00 02 02 00 02 02 00 00 00 00 04 04 00 07
00 00 00 00 02 02 02 00 02 02 02 02 02 02 02 02 02 04 04 04 04
06 06 06 06 00 00 04 00 00 00 00 00 00 02 02 00 00 00 00 00 00
06 06 06 06 00 00 04 00 04 04 00 05 05 02 02 00 00 00 00 02 02
04 04 04 04 00 00 06 06 06 06 06 05 05 02 02 04 04 04 04 02 02
05 05 05 05 00 00 06 06 06 06 06 05 05 05 05 05 05 00 00 00 00
05 05 05 05 00 00 02 00 00 00 07 05 05 05 05 05 05 06 06 02 02
05 05 05 05 00 00 02 02 00 02 02 02 02 02 00 00 00 06 06 02 02
05 05 00 00 00 02 00 02 00 00 00 00 00 02 00 02 02 02 02 04 04
05 05 04 04 00 02 00 00 00 02 02 02 00 02 00 00 00 00 07 02 02
07 00 00 00 00 00 00 00 01 02 03 02 00 02 00 02 02 00 00 02 02