02 07 00 00 00 00 00 00 04 04 04 04 00 00 00 00 00 00 00 00 07
00 00 00 04 04 04 00 00 00 00 07 00 00 00 04 05 05 04 04 04 00
00 04 04 00 00 00 00 04 04 00 00 05 05 00 00 00 00 00 00 04 00
00 04 04 00 04 04 04 04 00 05 05 04 04 00 04 04 04 04 00 04 00
00 00 00 00 00 00 00 00 00 05 05 04 04 00 04 04 04 04 00 04 00
00 04 04 00 04 04 00 05 05 04 04 04 04 00 04 04 05 05 00 04 04
00 04 04 00 04 04 04 05 05 04 04 00 00 00 04 04 05 05 00 04 04
00 00 04 00 04 04 04 04 00 00 00 00 04 04 05 05 00 00 00 00 00
04 00 00 00 00 00 00 04 00 04 07 00 04 04 05 05 00 05 05 04 00
04 00 00 04 04 04 00 04 00 04 04 04 05 05 00 00 00 05 04 04 00
00 07 04 04 04 04 00 04 00 04 04 04 05 05 00 05 05 05 04 00 07
00 04 04 00 00 00 00 04 00 04 04 04 00 00 00 05 04 04 04 00 02
00 04 04 00 00 00 00 00 00 05 05 05 00 05 05 05 04 04 04 00 02
00 04 04 04 04 04 04 00 00 05 05 05 00 05 04 04 00 00 00 00 02
00 00 00 00 00 04 04 00 00 00 00 00 00 05 04 04 00 07 00 04 04
04 04 04 00 00 04 04 00 00 02 02 02 00 05 04 04 00 04 04 04 04
04 04 04 00 00 00 00 00 01 02 03 02 00 00 00 00 00 00 00 00 00