02 05 00 00 00 04 04 07 00 04 00 04 04 00 00 05 05 05 05 00 00
02 00 02 02 00 04 04 00 00 00 00 02 02 00 00 02 02 00 00 02 02
02 00 02 02 00 00 00 00 02 00 02 02 02 07 00 02 02 00 00 02 02
02 00 02 02 00 00 00 02 02 00 00 00 00 00 00 02 02 04 04 02 00
02 07 00 00 00 02 02 02 00 00 00 04 04 00 00 02 02 04 04 02 07
05 05 00 00 00 02 02 00 00 00 00 04 04 00 00 04 04 00 00 04 04
05 05 05 00 00 00 00 00 00 02 02 00 00 00 00 04 04 00 00 04 04
05 05 05 02 02 02 02 00 00 02 02 00 00 00 00 02 02 05 05 00 00
02 00 02 02 02 02 02 05 05 05 05 05 05 04 04 00 00 05 05 02 02
02 00 00 00 00 04 04 05 05 05 05 05 05 04 04 00 00 05 05 02 02
04 04 02 02 07 04 04 05 05 02 02 07 00 02 02 00 00 05 05 00 07
04 04 02 02 00 04 04 00 00 02 02 00 00 02 02 00 02 02 00 00 00
02 00 02 02 00 02 02 00 00 02 02 02 02 02 02 00 02 02 00 02 00
02 00 02 02 00 02 02 00 00 02 02 02 02 02 02 00 00 00 00 02 00
02 00 02 02 00 02 02 00 00 00 00 00 00 00 00 00 00 02 04 02 02
02 00 02 02 00 00 00 00 00 02 02 02 00 02 00 02 00 02 04 02 02
02 00 02 02 00 02 02 01 00 02 03 02 00 02 02 02 00 00 00 00 00