02 02 02 02 02 02 02 02 02 02 02 02 02 02 02 02 02 02 02 02 02
02 02 02 02 02 02 02 02 00 02 00 02 00 02 02 02 02 02 02 02 02
02 00 00 02 02 02 02 02 00 02 00 02 00 02 02 02 02 02 00 00 02
02 02 00 02 02 00 02 02 00 02 04 02 00 02 02 00 02 02 00 02 02
02 02 00 02 02 00 02 02 00 02 04 02 00 02 02 00 02 02 00 02 02
02 07 00 02 02 00 02 02 00 00 00 00 00 02 02 00 02 02 00 07 02
02 00 00 00 00 00 00 00 00 02 00 02 00 00 00 00 00 00 00 00 02
02 04 04 00 02 02 02 02 00 02 00 02 00 02 02 02 02 00 04 04 02
02 04 04 00 02 02 02 02 00 00 07 00 00 02 02 02 02 00 04 04 02
02 07 00 00 00 00 00 00 00 02 00 02 00 00 00 00 00 00 00 07 02
02 00 00 02 02 02 02 02 00 02 00 02 00 02 02 02 02 02 00 00 02
02 02 00 02 02 02 02 02 00 02 02 02 00 02 02 02 02 02 00 02 02
02 02 00 02 02 00 02 02 00 02 00 02 00 02 02 00 02 02 00 02 02
02 07 00 02 02 00 02 02 00 02 00 02 00 02 02 00 02 02 00 07 02
02 00 00 02 02 00 02 02 00 00 00 00 00 02 02 00 02 02 00 00 02
02 02 00 02 02 00 02 02 00 02 02 02 00 02 02 00 02 02 00 02 02
02 02 00 00 00 00 00 00 01 02 03 02 00 00 00 00 00 00 00 02 02